wwwwwwwwwwwwwwwwwwwwwwwwww
wxxxxxo--o.o-----o.o...oow
wooooo.---------------.-.w
woo....-..o-.....-----w..w
w......-...-wwww--..oow..w
w--....o.---.o...-----wo-w
w--.....----Ao....o---wo-w
w...xx...o......o---.....w
w--------x..oo..o-----w..w
w--------x..-----.o......w
w-----e----------b-----..w
w-----------o....o.o.oo.ow
wwwwwwwwwwwwwwwwwwwwwwwwww