wwwwwwwwwwwwwwwwwwwwwwwwww
w-----------o---oxxxxxxxxw
w---------------ooooooooow
wooo......o-.....wwwwwwwww
w......-...-wwww--.......w
w--....o.---.o...-----wo-w
w--.....----Ao....o---wo-w
w........o......o---o....w
w--------x..oo..o-----w..w
w--------x..-----.o..o...w
w-----e----------b-----..w
w-----------o....o.o.oo.ow
wwwwwwwwwwwwwwwwwwwwwwwwww